服務生 (n) = waiter
家庭 (n) = family
堅守 黏住 (v) = stick
褓姆 (n) = babysitter
看 (v) = look
笑話 (n) = joke
耳環 (n) = earrings
狼 (n) = wolf
小心的 (adj) = careful
樣式 類型 (n) = pattern
男人 (n) = man
鞋子 (n) = shoes
無禮的 (adj) = impolite
現場的 直播的 (adj) = live
立即的 即時的 (adj) = instant
第三十 (num) = thirtieth
姪子 (n) = nephew
詭計 騙局 (n) = trick
春天 (n) = spring
古代的 (adj) = ancient
鴿子 (n) = pigeon
目的 意圖 (n) = purpose
電視 (n) = television
旗子 (n) = flag
存在 (v) = exist
蝸牛 (n) = snail
平常的 (adj) = usual
棒狀物 門閂 障礙 (n1) = bar
斑馬 (n) = zebra
鞠躬 (v) = bow
空氣 (n) = air
信封 (n) = envelope
送給 給 (v) = give
十六 (num) = sixteen
男孩 (n) = boy
取悅 請 (v) = please
粗心大意的 (adj) = careless
美國人 (n) = American
好處 優勢 (n) = advantage
喧鬧的 (adj) = noisy
包含 容納 裝入 (v) = contain
農場 飼養場 (n) = farm
騎馬 乘車 (v) = ride
第八 (num) = eighth
發送 寄出 (v) = send
方法 辦法 (n) = method
指甲 釘子 (n) = nail
像這樣的 (adj) = such
社會 (n) = society
為了 (prep) = for
貯存 (v) = store
錄音帶 膠帶 (n) = tape
吸管 稻草 (n) = straw
毛巾 (n) = towel
影響 (n) = influence
南瓜 (n) = pumpkin
東方 (n) = east
底片 膠捲 (n) = film
中華民國 (n1) = Republic of China
左邊的 (adj) = left
空白的 (adj) = blank
道路 (n) = road
小時 (n) = hour
山羊 (n) = goat
牛排 (n) = steak
等待 (v) = wait
近來的 最近的 (adj) = recent
標準的 (adj) = standard
有魔力的 (adj) = magic
手指 (n) = finger
大自然 性質 (n) = nature
出現 (v) = appear
活動 (n) = activity
寂寞的 孤獨的 (adj) = lonely
麵包 (n) = bread
模型 典範模特兒 (n) = model
突發爆發 (v) = burst
老板 (n) = boss
鏡子 (n) = mirror
挑選 精選 (v) = select
年齡 (n) = age
罐頭 桶子 (n) = can
葡萄 (n) = grape
山谷 溪谷 (n) = valley
處理 (v) = handle
聰明的 (adj) = smart
奶油 (n) = butter
鬼鬼祟祟的 (adj) = sneaky
包括 包含 (v) = include
情人節 (n1) = Valentine's Day
洋梨 (n) = pear
地面888 (n) = ground
航空器 (n) = aircraft
決定 (v) = decide
青少年時期 (n) = youth
看法 觀點 點 (n) = point
出售 (n) = sale
名字 (n) = name
缺席的 不在場的 (adj) = absent
老鷹 (n) = eagle
書櫥 架子 (n) = shelf
民主政治 (n) = democracy
派對 (n) = party
正確的 準確的 (adj) = exact
運載 帶著 (v) = carry
甜的 (adj) = sweet
電子的 (adj) = electric
引擎 發動機 (n) = engine
歐洲 (n1) = Europe
幼年時期 (n) = childhood
評論 (n) = comment
出售 賣出 (v) = sell
教授 (n) = professor
當..時 (conj) = while
輪子 (n) = wheel
伙伴 拍檔 (n) = partner
金屬 (n) = metal
受歡迎的 (adj) = welcome
閃電 (n) = lightning
再(一次) (adv) = again
射擊 開槍 (v) = shoot
躲避球 (np) = dodge ball
森林 (n) = woods
時間 (n) = time
日記 (n) = diary
臉 (n) = face
下一個 接著的 (adj) = next
已婚的 (adj) = married
真誠的 (adj) = sincere
垃圾 (n) = trash
長凳 (n) = bench
手臂 (n) = arm
風 (n) = wind
牛仔褲 (n) = jeans
時期 期間 (n) = period
記錄 (n) = record
方式 道路 (n) = way
橋 橋樑 (n) = bridge
工業 產業 (n) = industry
不誠實的 (adj) = dishonest
個人的 (adj) = individual
(風雨)襲擊 打掃 (v) = sweep
午餐 (n) = lunch
困難的 (adj) = difficult
醜的 難看的 (adj) = ugly
日本的 日本人 日語 (n1) = Japanese
點心 (n) = dessert
疼痛 痛苦 傷痛 (n) = pain
城鎮 市鎮 (n) = town
重的 (adj) = heavy
天資 天份 (n) = talent
季節 (n) = season
原則 (n) = principle
逮捕 拘捕 (n) = arrest
微笑 笑容 (v) = smile
球鞋 休閒鞋 (n) = sneakers
飛機的航程 (n) = flight
視覺 視力 (n) = sight
明亮的 (adj) = bright
手腕 腕關節 (n) = wrist
容易的 (adj) = easy
遙遠的 (adj) = far
個人的 私人的 (adj) = personal
計劃 方案 (n) = plan
活潑的 主動的 (adj) = active
青少年 (n) = teenager
陳述 聲明 說明 (v) = state
句子 (n) = sentence
跑 (v) = run
漫畫 (n) = comic
市場 市集 (n) = market
背後的 後面的 (adj) = back
有力量的 有威力的 (adj) = powerful
力量 武力 兵力 (n) = force
遙遠的 (adj) = distant
有智慧的 (adj) = wise
軍官 (n) = officer
沒有 而不會 (prep) = without
大量的 大規模的 (adj) = mass
百貨商店 (np) = department store
顧客 消費者 (n) = customer
世紀 一百年 (n) = century
今晚 (adv) = tonight
枕頭 (n) = pillow
討論 商議 (v) = discuss
馬 (n) = horse
陣雨 淋浴 (n) = shower
真正地 (adv) = really
失敗 (n) = failure
限制 (n) = limit
流動 流逝 漲潮 (n) = flow
攝影師 (n) = photographer
硬幣 錢幣 (n) = coin
女孩 (n) = girl
尚未 還沒有 (adv) = yet
波浪 (n) = wave
老虎 (n) = tiger
胃 (n) = stomach
最大的 (adj) = maximum
全部的 (adj) = all
職業 事業 (n) = career
人人 (pron) = everyone
玻璃杯 (n) = glass
美麗的 (adj) = beautiful
暴風雨 騷動 動亂 (n) = storm
作夢 (v) = dream
越過 在更遠處 (prep) = beyond
澳洲的 澳洲人 (n1) = Australian
建築物 房屋 (n) = building
原因 (n) = reason
愛滋病 (n) = AIDS
節省 拯救 保存 (v) = save
底部 (n) = bottom
景色 風景 場景 (n) = scene
記憶力 (n) = memory
蛋糕 糕餅 (n) = cake
富有的 (adj) = rich
親吻 (v) = kiss
口渴的 (adj) = thirsty
冷凍機 (n) = freezer
握(手) 搖動 (v) = shake
民主政治的 民主的 (adj) = democratic
最愛的 (adj) = favorite
公司 (n) = firm
獨立的 (adj) = independent
油 (n) = oil
興趣 (n) = interest
(專門)技術 技能 技巧 (n) = skill
炸彈 (n) = bomb
普通的 (adj) = common
風箏 (n) = kite
為…歡呼、鼓舞 (v) = cheer
泥漿 泥巴 (n) = mud
以…為基礎、根據 (v) = base
海灘 (n) = beach
寫 (v) = write
打開 (v) = open
一部分 一小段 (n) = section
潮濕的 (adj) = humid
女服務生 (n) = waitress
聽起來 (v) = sound
(精神上的)壓力 (n) = stress
咖啡 (n) = coffee
歐洲的 歐洲人 (n1) = European
中午 (n) = noon
一旦 一次 (adv) = once
渴望 (v) = long
揚帆 航行 (v) = sail
目標 目的 (n) = aim
選票 選舉 (v) = vote
秘書 (n) = secretary
死 (v) = die
無論如何 不管怎麼說 (adv) = anyway
娶 嫁 和…結婚 (v) = marry
身材 身影 (n1) = figure
運動 (n) = sports
習俗 慣例 (n) = custom
珍貴的 貴重的 (adj) = precious
巴士 公車 (n) = bus
按 壓 (v) = press
造成 (v) = cause
毛線衣 (n) = sweater
纖細的、苗條的 (adj) = slim
收藏品 收集 (n) = collection
橘子 (n) = tangerine
高的 (adj) = high
二手的 (adj2) = used
需要 (v) = want
發燒 發熱 (n) = fever
直接的 (adj) = direct
領導 (n) = leader
便宜的 (adj) = cheap
有扶手的椅子 (n) = armchair
第二的 次要的 (adj) = secondary
假的 錯誤的 (adj) = false
天生的 (adj) = born
足球 (n) = soccer
專家 高手 (n) = expert
增加 增強 (v) = increase
聞起來 (v) = smell
延誤 耽擱 延後 (v) = delay
接觸 聯絡 (v) = contact
全部 所有 (n) = all
關心 看護 (n) = care
勝利 (n) = victory
在…裡面 (prep) = inside
事情 事件 戀情 (n) = affair
購買 採購 (v) = purchase
銀行家 (n) = banker
蟲 (n) = worm
校園 校區 (n) = campus
認為 計算 (v) = figure
列印 印刷 用印刷體寫 (v) = print
想家的 得思鄉病的 (adj) = homesick
原諒 藉口 (n) = excuse
學習 (v) = learn
大學 (n) = university
揮舞 揮動 (v) = wave
牙齒 (n) = tooth
堅持 堅決 (v) = insist
直尺 (n) = ruler
衣服 (n) = clothes
巨大的 龐大的 (adj) = large
尾巴 尾部 (n) = tail
胖的 (adj) = fat
正式的 (adj) = formal
母牛 奶牛 (n) = cow
借(出) (v) = lend
北方的 北部的 (adj) = northern
郵差 (n) = mailman
參加 出席 照顧 (v) = attend
運轉 操作 經營 (v) = operate
國家的 (adj) = national
相等的 相當的 (adj) = equal
人物 重要人物 (n2) = figure
儀器 器具 (n) = instrument
網際網路 (n) = Internet
或許 (adv) = probably
七月 (n) = July
力量 (n) = power
狹窄的 (adj) = narrow
自助餐 (n) = buffet
經驗 體驗 (n) = experience
夏天 (n) = summer
翅膀 機翼 (n) = wing
討論 (n) = discussion
整理 安排 (v) = arrange
打電話給… (v) = dial
最後的 (adj) = last
元 (n) = dollar
星期六 (n) = Saturday
遊戲 (n) = game
俱樂部 社團 (n) = club
咬 叮 (v) = bite
某事 (pron) = something
繩索 (n) = rope
總是 (adv) = always
瞬間 片刻 (n) = moment
螞蟻 (n) = ant
國家 (n) = country
昂貴的 (adj) = expensive
天真的 (adj) = childlike
尋找 探索 (v) = seek
牛奶 (n) = milk
棕色的 (adj) = brown
節日 喜慶日 (n) = festival
多采多姿的 (adj) = colorful
垃圾 (n) = garbage
六十 (n) = sixty
知道的 意識到的 (adj) = aware
有可能的 (adj) = possible
排球 (n) = volleyball
卡片 (n) = card
選擇 (v) = choose
餐館 (n) = restaurant
傷害 (n) = injury
衝浪 飆網 (v) = surf
豆腐 (n) = tofu
節日 假日 (n) = holiday
死亡 (n) = death
準備 (v) = prepare
主婦 (n) = housewife
小孩子 (n) = child
種子 (n) = seed
焦點 (n) = focus
過(河、街) (v) = cross
天花板 (n) = ceiling
很快地 不久 (adv) = soon
吃起來 (v) = taste
較少的 不重要的 (adj) = minor
武器 (n) = weapon
蔬菜 (n) = vegetable
魚 (n) = fish
腰帶 (安全)帶 (n) = belt
有規則的 (adj) = regular
道歉 (v) = apologize
經典作品 (n) = classic
公平的 (adj) = fair
玩具 (n) = toy
鯊魚 (n) = shark
令人愉快的 (adj) = pleasant
選舉 (n) = election
注射 (n1) = shot
溜冰 (v) = skate
寧可 (adv) = rather
流行音樂 (np) = pop music
生產 (n) = production
蠟燭 (n) = candle
獵人 (n) = hunter
必需 (aux) = must
親密的 (adj) = close
喇叭 (n) = trumpet
書桌 (n) = desk
職員 (n) = clerk
使…興奮 (v) = excite
第十 (num) = tenth
最近 近來 (adv) = recently
關起來 (v) = close
任何一個 (adj) = any
你自己 (pron_R) = yourself
主題 題目 (n) = topic
出生的 誕生的 (adj) = born
蝦子 (n) = shrimp
急忙 倉促 忙亂 (v) = hurry
負的 (adj) = minus
極小的 微小的 (adj) = tiny
覆蓋 (v) = cover
庭院 院子 (n) = yard
食物 (n) = food
一張紙 床單 (n) = sheet
電話 (n) = telephone
問題 (n) = question
幾乎不 簡直不 (adv) = hardly
化學 (n) = chemistry
忽略 省略 (v) = omit
棒球 (n) = baseball
小氣的 (adj) = stingy
手帕 (n) = handkerchief
柳橙 (n) = orange
幼稚的 (adj) = childish
媒體 (n) = media
井 (n) = well
運動 活動 (n) = movement
哪個 (wh) = which
粗魯的 無禮的 (adj) = rude
這裡 (adv) = here
時期 階段 (n1) = stage
萬聖節 (n) = Halloween
二十 (num) = twenty
加上補充 (prep) = plus
公克 (n) = gram
友誼 (n) = friendship
堆積 堆疊 (n) = pile
雖然 (conj) = although
蠟筆 (n) = crayon
歸還 返回 (v) = return
操作 手術 (n) = operation
主人 (n) = master
受到驚嚇的 (adj) = scared
體育館 (n) = gym
外套 (n) = coat
痊癒 復原 (v) = recover
每週的 (adj) = weekly
公車站牌 (n) = stop
郵票 (n) = stamp
小組 (n) = group
入口 門口 (n) = entrance
方式 態度 (n) = manner
風格 作風 (n) = style
不是的 (adv) = not
現在 (adv) = now
背心 (n) = vest
描寫 敘述 (v) = describe
正面的 積極的 (adj) = positive
吉他 (n) = guitar
職業 工作 (n) = job
愚蠢的 傻的 (adj) = foolish
頭髮 (n) = hair
主要的 (adj) = main
公里 (n) = kilometer
母親節 (n1) = Mother's Day
健談的 (adj) = talkative
大門 (n) = gate
邪惡的 (adj) = evil
手電筒 (n) = flashlight
成長 種植 (v) = grow
陸軍上尉 隊長 (n) = captain
需要 要求 (v) = require
下雨 (v) = rain
村莊 村子 (n) = village
貧困的 (adj) = poor
河馬 (n) = hippo
首先 (adv) = first
床 (n) = bed
強調 著重 (v) = emphasize
辦公室 (n) = office
發生 (v) = happen
岩石 (n) = rock
妻子 (n) = wife
拒絕 (v) = refuse
接觸 聯絡 (n) = contact
打斷 妨礙 (v) = interrupt
郊遊 野餐 (n) = picnic
烤土司 (n) = toast
加熱器 暖氣機 (n) = heater
瓦斯氣體 (n) = gas
耳朵 (n) = ear
學生 (n) = student
射籃 (n3) = shot
袖珍的 小型的 (adj) = pocket
說話者 演講者 (n) = speaker
鞦韆 (n) = swing
察覺 查出 偵測 探知 (v) = detect
得到 獲得 (v) = gain
蒼白的 (adj) = pale
謙遜的 (adj) = humble
整理 分類 (v) = sort
鉛筆 (n) = pencil
生日 (n) = birthday
輕輕的 (adj) = light
棍子 手杖 (n) = stick
書架 (n) = bookcase
多雪的 (adj) = snowy
公民 居民 (n) = citizen
士兵 (n) = soldier
十五 (num) = fifteen
海外的 國外的 (adj) = overseas
浪費 廢棄物 (n) = waste
項鏈 (n) = necklace
鴿子 (n) = dove
主修 (v) = major
地球 (n) = earth
星期四 (n) = Thursday
潮濕的 (adj) = wet
慾望 渴望 (n) = desire
污染 弄髒 (v) = pollute
使用 (v) = use
通常 (adv) = usually
肚子 (n) = tummy
感情 (n) = emotion
乘客 旅客 (n) = passenger
黑色的 (adj) = black
高度 (n) = height
得到 (v) = get
熱度 (n) = heat
點 (n) = dot
最後的 (adj) = bottom
一月 (n) = January
雖然 (conj) = though
飛行 (v) = fly
一千 (num) = thousand
面試 採訪 (n) = interview
非常地 (adv) = very
音樂 (n) = music
表示…的意思 (v) = mean
導遊 引導 指導 (n) = guide
父母親 (n) = parent
比薩餅 (n) = pizza
幫忙 援助 (v) = aid
大聲的 (adj) = loud
案件 (n) = case
在…下面 (prep) = below
金銀財寶 (n) = treasure
大頭針 別針 (n) = pin
訊息 消息 (n) = message
提供 (v) = provide
依賴 依…而定 (v) = depend
公司 (n) = company
麥克筆 (n) = marker
習慣 (n) = habit
先生 長官 (n) = sir
日 (n) = day
超級市場 (n) = supermarket
網子 網路 (n) = net
較遠的 (adj2) = farther
姊妹 (n) = sister
纜繩 (n) = cable
印表機 (n) = printer
德國 (n1) = Germany
有效的 (adj) = effective
茶壺 (n) = teapot
妖怪 怪物 (n) = monster
突然 (adv) = suddenly
收音機 (n) = radio
人 傢伙 朋友 同伴 (n) = fellow
星期天 (n) = Sunday
清單 名冊 (n) = list
基礎的 基本的 (adj) = basic
責任 義務 (n) = duty
停車場 (n) = parking lot
希望 願望 (v) = wish
偷竊 (v) = steal
允許 (v) = allow
習慣…的 (adj1) = used
把...弄糊塗 使...困惑 (v) = confuse
英國 (n1) = England
短褲 (n) = shorts
拿 (v) = take
結束的 (adj) = over
英國 (n1) = Britain
測驗 考查 (n) = quiz
否定的 負面的 (adj) = negative
黎明 拂曉 (n) = dawn
失敗者 (n) = loser
雙十節 (n1) = Double Tenth day
男演員 (n) = actor
籃子 (n) = basket
三 (num) = three
廁所 洗手間 (n) = toilet
慢慢的 (adj) = slow
博物館 (n) = museum
監獄 牢獄 (n) = prison
情人節 (n) = Valentine
生活 (n) = life
嫉妒的 (adj) = jealous
(長篇)小說 (n) = novel
隧道 (n) = tunnel
期間 期限 (n) = term
任何事情 (pron) = anything
瀑布 (n) = waterfall
複製 抄襲 (v) = copy
岸 (n) = shore
祕密 (n) = secret
資料 數據 (n) = data
在...之間 (prep) = between
海 (n) = sea
石頭 石塊 (n) = stone
湖 (n) = lake
尺寸 大小 (n) = size
磅(重量) 英鎊 (n) = pound
花園 (n) = garden
比較 (v) = compare
溫和的 輕柔的 (adj) = gentle
突然 (n) = sudden
老的 舊的 (adj) = old
磚塊 (n) = brick
軍隊 陸軍 (n) = army
未婚夫妻 情侶 (n) = couple
特定的 特別的 (adj) = particular
郵差 (n) = mail carrier
陸地 (n) = land
餵食 飼養 (v) = feed
吉普車 (n) = jeep
第一的 (adj) = first
程度 (n) = level
傻瓜 笨蛋 (n) = fool
旅程 (n) = trip
檸檬 (n) = lemon
家事 (n) = housework
充滿的 (adj) = full
捷運 (n) = MRT
地方性的 當地的 (adj) = local
種類 (n) = sort
它的 (pron_adj) = its
嘴唇 (n) = lip
亞洲 (n1) = Asia
照片 相片 (n) = photograph
某人 (pron) = someone
聖誕節 (n) = Christmas
舒適的 (adj) = comfortable
使…滿意 (v) = satisfy
噪聲 (n) = noise
古典的 極好的 (adj) = classical
圓形的 (adj) = round
冬天 (n) = winter
父親 (n) = father
黃金 (n) = gold
游泳 (v) = swim
有信心的 (adj) = confident
支付 付帳 (v) = pay
生病的 (adj) = ill
發光 (陽光)照耀 (v) = shine
飛機 (n) = plane
藍色的 (adj) = blue
筷子 (n) = chopsticks
婚姻 (n) = marriage
相片 (n) = photo
鳥 (n) = bird
文化 (n) = culture
開(槍砲) (v2) = fire
直到 (conj) = till
燈光 光線 (n) = light
豬 (n) = pig
家庭作業 (n) = homework
超級的 (adj) = super
樣品 樣本 (n) = sample
推銷員 (n) = salesman
漫畫的 喜劇的 (adj) = comic
電燈 (n) = lamp
樂趣 娛樂 (n) = fun
表達 (v) = express
三角形 (n) = triangle
人性的 人類的 (adj) = human
滑倒 失足 滑落 (v1) = slip
字彙 (n) = vocabulary
把…浸入 為…洗澡 (v) = bathe
澆水 (v) = water
品質 素質 (n) = quality
沸騰煮沸 (v) = boil
脖子 (n) = neck
警察 (n) = police
正式的 官方的 (adj) = official
幽默的 (adj) = humorous
安全的 (adj) = safe
撕開 撕裂 拆掉 (v) = tear
確定的 既定的 (adj) = set
完成 達成 達到(目標) (v) = achieve
漢堡 (n) = burger
公分 (n) = centimeter
可愛的 (adj) = lovely
美國 (n) = USA
整個的 全部的 (adj) = entire
你的東西 (pron_n) = yours
分數 (n) = score
中文 華人 (n) = Chinese
結束 完成 (v) = finish
首領 機關首長 (n) = chief
十月 (n) = October
塔樓 (n) = tower
攀登 攀爬 (v) = climb
寬的 廣泛的 (adj) = broad
努力 盡力 (n) = effort
領悟 了解 (v) = realize
中心的 中央的 (adj) = central
狗 (n) = dog
較高的 上面的 (adj) = upper
韓國 (n1) = Korea
城堡 (n) = castle
他們 (pron_o) = them
褲子 (n) = pants
在…之中 (prep) = among
英哩 (n) = mile
副本 (n) = copy
拜訪 參觀 (v) = visit
涼快的 (adj) = cool
粉末 (n) = powder
口袋 (n) = pocket
戰爭 (n) = war
公寓 (n) = apartment
十八 (num) = eighteen
腳踏車 (n) = bike
在...以前 (conj) = before
活動 行動 (n) = action
投遞 達成 (v) = deliver
危險的 (adj) = dangerous
外面的 (adj) = outside
鴨子 (n) = duck
十 (num) = ten
優勝者 (n) = winner
玩偶 洋娃娃 (n) = doll
兒子 (n) = son
結果 (n) = result
溫度 氣溫 (n) = temperature
事情 問題 (n) = matter
街道 (n) = street
忙碌的 (adj) = busy
有關的 相對的 (adj) = relative
西瓜 (n) = watermelon
誰 (wh) = who
操場 (n) = playground
搜查 搜尋 (n) = search
黃色的 (adj) = yellow
設置 安裝 (v) = set
距離 (n) = distance
相像的 類似的 (adj) = similar
關上 關閉 (v) = shut
成長 發育 (n) = growth
服務 (n) = service
肩膀 (n) = shoulder
整齊的 (adj) = tidy
新聞 消息 (n) = news
航空公司 (n) = airlines
董事會委員會 木板 (n) = board
通過 (v) = pass
誠實 (n) = honesty
十二月 (n) = December
澳洲 (n1) = Australia
動物園 (n) = zoo
飢餓的 (adj) = hungry
許多(接可數名詞) (adj) = many
七十 (num) = seventy
傷心的 (adj) = sad
州 (n) = state
切 割 (v) = cut
短暫的 簡短的 (adj) = brief
似乎 (v) = seem
元宵節 (n1) = Lantern Festival
籠子 (n) = cage
戲劇 (n) = play
毀壞 破壞 (v) = damage
維持 保持 保養 維修 (v) = maintain
報告 紙張 (n) = paper
指控 充電 刷(卡) (v) = charge
牙科醫生 (n) = dentist
八 (num) = eight
我的東西 (pron_n) = mine
聲稱 要求 (v) = claim
熱狗 (n) = hot dog
桌球 (np) = table tennis
拖鞋(尤指室內穿) (n) = slippers
同樣的 (adj) = same
校長 (n) = principal
銀行 堤岸 (n) = bank
另外的 (adj) = else
英語 (n) = English
粉筆 (n) = chalk
年輕的 (adj) = young
假期 (n) = vacation
建議 提議 (v) = suggest
祈禱 祈求 (v) = pray
火雞 (n) = turkey
平臺 月臺 (n) = platform
失敗 (v) = fail
萵苣 (n) = lettuce
冰 (n) = ice
海洋 大海 (n) = ocean
工人 (n) = worker
自己 (pron) = own
感謝 欣賞 (v) = appreciate
洗滌槽 水槽 (n) = sink
腳 (n) = foot
流動 隨風飄動 (v) = flow
掘(土) 挖(洞) (v) = dig
更多 更甚 (adv) = more
繪製 描寫 (v) = draw
片 (n) = slice
充滿 (v) = fill
最主要的 (adj) = chief
野生的 (adj) = wild
借(入) (v) = borrow
敵人 (n) = enemy
麵包店 (n) = bakery
航空公司 (n) = airline
我們的 (adj) = our
夢想 (n) = dream
國王 (n) = king
在...附近 (prep) = around
要求 詢問 (v) = ask
在...下面 (prep) = under
卡通 (n) = cartoon
啞的 沉默寡言的 (adj) = dumb
紅蘿蔔 (n) = carrot
皇后 女王 (n) = queen
疲憊的 很累的 (adj) = tired
池塘 (n) = pond
三十 (num) = thirty
湯匙 (n) = spoon
工作 (n) = work
有時候 (adv) = sometimes
檢查 檢驗 (v) = check
舔 (v) = lick
塞車 果醬 (n) = jam
青蛙 (n) = frog
八十 (num) = eighty
鼻子 (n) = nose
鹹的 (adj) = salty
瞎的 (adj) = blind
高爾夫球運動 (n) = golf
墨水 (n) = ink
婦女兒童短衫 (n) = blouse
到處 (adv) = everywhere
筆記本 (n) = notebook
每個 (det) = each
湯 (v) = soup
司機 (n) = driver
除夕 (n) = New Year's Eve
班級 (n) = class
放下 下蛋 (v) = lay
我們自己 (pron_R) = ourselves
半夜的 (adj) = midnight
邊緣 (n) = edge
南方的 南部的 (adj) = southern
火車 (n) = train
海島 (n) = island
鎮靜 沈著 (v) = calm
臀部 屁股 (n) = hip
法官 (n) = judge
殺害 (v) = kill
乳酪 (n) = cheese
木製的 (adj) = wooden
窗簾 門簾 (n) = curtain
受傷 (v) = wound
加拿大的 加拿大人 (n1) = Canadian
充足的 (adj) = enough
自由的 免費的 (adj) = free
阻塞 (v) = block
燃燒 (v) = burn
一起 (adv) = together
雇用 (v) = employ
真正的 (adj) = real
烤箱 (n) = oven
世界 (n) = world
增加 (v) = add
悄悄放進 溜出 潛入 (v2) = slip
糖果 (n) = candy
他自己 (pron_R) = himself
列出來 (v) = list
感謝 (v) = thank
東方的 東部的 (adj) = eastern
門鈴 (n) = bell
球 (n) = ball
表面 水面 (n) = surface
浴室 (n) = bathroom
打包 裝箱 (v) = pack
成為 變得 (v) = become
深的 (adj) = deep
爭論 吵架 (v) = argue
意思 涵義 (n) = meaning
反對 (prep) = against
摘取 挑選 (v) = pick
綿羊 (n) = sheep
午夜 (n) = midnight
手機 (np) = cellphone
守衛 警衛 (n) = guard
醒來 (v) = wake
袋子 (n) = bag
忘記 (v) = forget
蜂蜜 (n) = honey
文具 (n) = stationery
他們的東西 (pron_n) = theirs
地鐵 (n) = subway
好的 (adj) = nice
昨天 (n) = yesterday
火爐 (n) = stove
親戚 親屬 (n) = relative
雞肉 小雞 (n) = chicken
有能力的 (adj) = able
流行的 時髦的 (adj) = fashionable
指示 指出 (v) = indicate
旅遊 參觀 (n) = tour
露營 (v) = camp
簡單地 只是 (adv) = simply
政府 (n) = government
照片 圖片 (n) = picture
創造 創作 (v) = create
公共的 (adj) = public
適合 與...相稱 (v) = suit
一張(片、塊) (n) = piece
在…旁邊 除…以外 (prep) = besides
親愛的 (adj) = dear
擁抱 (n) = hug
然後 (adv) = then
夜晚 (n) = night
官員 公務員 (n) = official
搶劫 (v) = rob
塑造 (v) = shape
取消 (v) = cancel
其他的 (adj) = other
鍋子 (n) = pot
無聲 寂靜 (n) = silence
平的 (adj) = level
地下道 下交叉道 (n) = underpass
狐狸 (n) = fox
圓 (n) = circle
巢 窩 (n) = nest
四月 (n) = April
明天 (n) = tomorrow
鑽石 (n) = diamond
愛人 情人 愛好者 (n) = lover
病人 (n) = patient
金錢 (n) = money
書本 (n) = book
賊 小偷 (n) = thief
外國的 (adj) = foreign
火 (n) = fire
頻道 海峽 (n) = channel
衣架 (n) = hanger
提供 提議 (v) = offer
成年人 (n) = adult
腳踏車 (n) = bicycle
知識 學問 (n) = knowledge
計量單位 測量 措施 (n) = measure
收集 聚集 (v) = gather
猴子 (n) = monkey
雨衣 (n) = raincoat
動手術 (v) = operate
散步 (v) = walk
肥胖的 (adj) = chubby
希望 (v) = hope
那裡 何處 (wh) = where
親切的 (adj) = friendly
大象 (n) = elephant
有用的 有益的 (adj) = useful
機車 速克達 (n) = scooter
兔子 野兔 (n) = rabbit
遺憾的 (adj) = sorry
一些 (adj) = few
在…存活 (v) = survive
背包 (n) = backpack
口罩 (n) = mask
公路 幹道 (n) = highway
舌頭 (n) = tongue
惡名昭彰的 (adj) = notorious
十字架 (n) = cross
生氣的 發瘋的 (adj) = mad
端午節 (n1) = Dragon-boat Festival
蛇 (n) = snake
朋友 (n) = friend
理髮 (n) = haircut
停留 留下 (v) = stay
處理 (v) = deal
下午 (n) = afternoon
想法 思想 (n) = thought
正確的 (adj) = correct
運氣 機會 (n) = chance
沐浴 (n) = bath
孫女 (n) = granddaughter
根據 基礎 (n) = basis
跳躍 (v) = jump
否認 拒絕 (v) = deny
茶杯的托碟 (n) = saucer
碗 (n) = bowl
作者 作家 (n) = writer
袋鼠 (n) = kangaroo
努力的 (adj) = diligent
善良 (n) = goodness
十七 (num) = seventeen
堂(表)兄弟姐妹 (n) = cousin
毀滅 破壞 (v) = ruin
進攻 襲擊 (v) = attack
蹤跡 足跡 小徑 (n) = track
溫暖的 暖和的 (adj) = warm
減 (prep) = minus
在...旁邊 除了…之外 (prep) = beside
中華民國 (n) = ROC
主要的 (adj) = major
字典 (n) = dictionary
有幫助的 (adj) = helpful
河馬 (n) = hippopotamus
唱歌 (v) = sing
勇敢的 英勇的 (adj) = brave
談話 (v) = talk
男盥洗室 (np) = men's room
高雄 (n1) = Kaohsiung
新的 (adj) = new
右邊的 正確的 (adj) = right
護士 (n) = nurse
麵條 (n) = noodle
槍 (n) = gun
原諒 寬恕 (v) = forgive
幫浦(抽水裝置) (n) = pump
七 (num) = seven
讀 (v) = read
聾的 (adj) = deaf
行動 移動 (v) = move
強迫 (v) = force
電話 (n) = phone
剛開始的 初級的 (adj) = beginning
英吋 (n) = inch
地址 (n) = address
獎賞 獎品 (n) = prize
王子 (n) = prince
很棒的 好極了 (adj) = terrific
草蓆 (n) = mat
公升 (n) = liter
處罰 懲處 (v) = punish
努力地 艱苦地 (adv) = hard
在…的對面 (prep) = across
前往… (prep) = toward
嬰孩 (n) = baby
強壯的 (adj) = strong
影像 影片 (n) = video
飲食 (n) = diet
沈默的 (adj) = quiet
廚師 (n) = cook
製做 泡(茶) (v) = make
巨人 (n) = giant
廣播節目 (n) = broadcast
麵粉 (n) = flour
檢查 診察 (v) = examine
懶惰的 (adj) = lazy
燈籠 (n) = lantern
水龍頭 (n) = faucet
哈囉 (inter) = hello
鯨魚 (n) = whale
誰的 (wh) = whose
年長的 (adj) = elder
親切的 友善的 (adj) = kind
助手 助理 (n) = assistant
心臟 (n) = heart
小學 (np ) = elementary school
報告 (n) = report
感覺 覺得 (v) = feel
理髮師 (n) = barber
修改 校正 (v) = revise
成功 (v) = succeed
蟑螂 (n) = cockroach
幽靈 鬼魂 (n) = ghost
新加坡 (n1) = Singapore
臺灣 (n) = Taiwan
從… (prep) = from
是的 (adv) = yes
晚餐 (n) = dinner
總統 (n) = president
蹺蹺板 (n) = seesaw
壓力 (n) = pressure
樂隊 樂團 (n) = band
感到驚訝的 (adj) = surprised
三月 (n2) = March
僕人 佣人 (n) = servant
膝蓋 (n) = knee
孤單的 孤獨的 (adj) = alone
休息 (v) = rest
投票者 (n) = voter
木瓜 (n) = papaya
甘藍菜 (n) = cabbage
申請 應徵 應用 (v) = apply
快速的 (adj) = quick
介紹 引見 (v) = introduce
鼓 (n) = drum
柵欄 籬笆 (n) = fence
令人乏味的 (adj) = boring
麥片 穀物 (n) = cereal
瘦小的 (adj) = thin
木頭 木材 (n) = wood
今天 (adv) = today
畫家 (n) = painter
風景 景色 (n) = scenery
義大利麵條 (n) = spaghetti
十二 (num) = twelve
冰淇淋 (np) = ice cream
長褲 (n) = trousers
長的 (adj) = long
仇恨 憎恨 (v) = hate
城市商業區 鬧區 (n) = downtown
女廁所 (np) = women's room
繼續 (v) = continue
外銷 輸出 (v) = export
廚房 (n) = kitchen
簽名 (v) = sign
箱子 (n) = box
技工 修理師 (n) = mechanic
人類 (n) = human
小河 溪流 (n) = stream
小提琴 (n) = violin
成績 年級 (n) = grade
開放的 開著的 (adj) = open
解釋 說明 (v) = explain
馬鈴薯 洋芋 (n) = potato
番石榴 (n) = guava
每年一次的 (adj) = yearly
計劃 企劃 (n) = project
解決 (v) = solve
母雞 (n) = hen
錢包 (女用)手提包 (n) = purse
商店 (n) = shop
奶油 (n) = cream
抽屜 (n) = drawer
旁邊 (n) = side
家 (n) = home
發音 (v) = pronounce
責備 指責 (v) = blame
腳步 步驟 (n) = step
驚奇 詫異 令…驚訝 (v) = surprise
內衣 (n) = underwear
同學 (n) = classmate
孫子 (n) = grandson
聲音 嗓子 (n) = voice
日期 (n) = date
自從…以來 (prep) = since
堅固的 穩定的 堅定的 (adj) = firm
失去 喪失 (v) = lose
壞的 (adj) = bad
書店 (n) = bookstore
符號 標誌 (n) = sign
生產 (v) = produce
老鼠 滑鼠 (n) = mouse
快遞的 快速的 (adj) = express
水缸 貯水槽 坦克 (n) = tank
鹽 (n) = salt
藝術家 (n) = artist
甜瓜 (n) = melon
皇室的 (adj) = royal
分擔 分享 (v) = share
牧師 神父 (n) = priest
領帶 (n) = tie
廁所 (n) = restroom
感官 感覺 (n) = sense
窗口 (n) = window
龍 (n) = dragon
英俊的 (adj) = handsome
甜甜圈 (n) = doughnut
費用 (n) = fee
愉快 高興 (n) = pleasure
部門 分隔 區分 (n) = division
玩(遊戲) 扮演 (v) = play
柔軟的 (adj) = soft
貓 (n) = cat
認為 視為 (v) = regard
字 (n) = word
不可能的 (adj) = impossible
工作日 (n) = weekday
實例 事例 情況 (n) = instance
線 (n) = line
西方 西邊 (n) = west
學院 (n) = college
醬油 (n) = soy-sauce
令人驚歎的 (adj) = marvelous
田地 牧場 (n1) = field
衣櫃 壁櫥 (n) = closet
簡單的 容易的 (adj) = plain
芒果 (n) = mango
購買 (v) = buy
規則 規定 (n) = rule
蚊子 (n) = mosquito
接受 (v) = accept
倒退的 落後的 (adj) = backward
磨擦 (v) = rub
差別 差異 (n) = difference
進行曲 行軍 (n1) = march
出現 外貌 (n) = appearance
角色 性格 (n) = character
想像 (v) = imagine
早餐 (n) = breakfast
水蒸氣 (n) = steam
事實 (n) = fact
小的 (adj) = small
點心 (n) = snack
一打 十二個 (n) = dozen
地下室 (n) = basement
健康 (n) = health
轉角處 街角 (n) = corner
美髮師 (np) = hairdresser
直昇機 (n) = helicopter
卡車 (n) = truck
最好的 (adj) = best
同伴的 (adj) = fellow
離開 (v) = leave
很可能的 (adj) = likely
困難的 堅硬的 (adj) = hard
收入 所得 (n) = income
領導 (v) = lead
姪女 外甥女 (n) = niece
消息 資訊 (n) = information
小山丘 (n) = hill
恐龍 (n) = dinosaur
精力充沛的 (adj) = energetic
擁擠的 (adj) = crowded
蝴蝶 (n) = butterfly
滑稽的 (adj) = funny
鑰匙 關鍵 (n) = key
打獵 捕捉 (v) = hunt
高興的 (adj) = pleased
避開 躲開 (v) = avoid
沿著 順著 (prep) = along
洩了氣的輪胎 (np) = flat tire
漂亮的 (adj) = pretty
餅乾 (n) = cookie
九月 (n) = September
花費 (v) = cost
聽見 (v) = hear
頭昏眼花的 (adj) = dizzy
西方的 (adj) = western
愛 (n) = love
讚揚 稱讚 (n) = praise
機器 (n) = machine
傑出的 (adj) = excellent
鐵鍋 (n) = wok
傳統 (n) = tradition
碟盤 (n) = dish
因此 所以 (adv) = therefore
高興的 (adj) = glad
隱形眼鏡 (np) = contact lens
區域 (n) = area
十四 (num) = fourteen
珍貴的 值錢的 (adj) = valuable
胃痛 (n) = stomachache
茶 (n) = tea
流行性感冒 (n) = flu
不含酒精的 (adj) = soft
歌曲 (n) = song
開除 (v) = fire
位置 姿勢 立場 (n) = position
英國的 英國人 (n1) = British
鐵路 (n) = railroad
肉 (n) = meat
直直的 (adj) = straight
衝突 (n) = conflict
簡報 摘要 (n) = brief
便利商店 (np) = convenience store
訓練 (v) = train
海岸 沿海地區 (n) = coast
詢問 (v) = question
因為 (conj) = because
後悔 悔恨 (v) = regret
熊 (n) = bear
拍手 (v) = clap
分鐘 (n) = minute
不同的 (adj) = different
帳篷 帳棚 (n) = tent
個人 (n) = person
重大打擊 (n) = blow
紫色的 (adj) = purple
酒吧 飲食販賣店 (n2) = bar
新奇的 (adj) = novel
教育常用單數 (n) = education
有趣的 (adj) = interesting
關著的 (adj) = off
慢跑 (v) = jog
俄國的 俄國人 俄語 (n1) = Russian
語言 (n) = language
郡 縣 (n) = county
系統 (n) = system
欺詐 作弊 欺騙 (v) = cheat
早晨 (n) = morning
嘴巴 (n) = mouth
陷阱 (n) = trap
農夫 (n) = farmer
鹿單複數同形 (n) = deer
感到興奮的 (adj) = excited
接觸 感動 (v) = touch
客人 來賓 (n) = guest
添加 此外 (n) = addition
重要性 (n) = importance
派 (n) = pie
生意 事情 (n) = business
襪子 (n) = socks
刷子 (n) = brush
邀請 招待 (v) = invite
到達 到來 (v) = arrive
牙痛 (n) = toothache
主演 行動 (v) = act
價格 (n) = price
已經 (adv) = already
認為 (v) = think
發生 出現 突然浮現 (v) = occur
死的 (adj) = dead
特別 尤其 縮寫為 (adv) = especially
直到...時 (prep) = until
轉動 (v) = turn
油煎 油炸 炒 (v) = fry
任何人 (pron) = anyone
洋裝 (n) = dress
學期 (n) = semester
賺得 掙得 (v) = earn
橡皮擦 (n) = eraser
新鮮的 (adj) = fresh
虛弱的 (adj) = weak
類型 (n) = type
保護 防禦物 保護物 (n) = protection
承認 准許進入 (v) = admit
汽車 (n) = car
鈕扣 按鈕 (n) = button
電冰箱 (n) = refrigerator
在...期間 (prep) = during
長沙發 (n) = couch
花(錢) 花費 (v) = spend
可能 也許 (adv) = maybe
瘋狂的 (adj) = crazy
記錄器 錄音機 (n) = recorder
小狗 (n) = puppy
任何地方 (adv) = anywhere
驕傲的 (adj) = proud
減少 減弱 (v) = decrease
大聲地 (adv) = aloud
吠叫(狗、狐等) (v) = bark
停止 中斷 (v) = stop
帶來 (v) = bring
欣賞 欽佩 仰慕 (v) = admire
公平的 (adj) = just
還有 也是(會) (adv) = also
店主 (n) = shopkeeper
鐵鎚 鎯頭 (n) = hammer
當…的時候 (wh) = when
工作 任務 (n) = task
現金 現款 (n) = cash
鍛鍊 運動 練習 (v) = exercise
契約 合同 (n) = contract
單位 單元 (n) = unit
洞 (n) = hole
T恤杉 (n) = T-shirt
上述的, 上面的 (adj) = above
勤勉的 (adj) = hard-working
爆米花 (n) = popcorn
眼鏡 (n) = glasses
有把握的 (adj) = sure
放慢 (v) = slow
划(船) (v) = row
移動 動作 (n) = motion
傳統的 (adj) = traditional
曾經 (adv) = ever
清洗 (v) = clean
信念 想法 信仰 (n) = belief
輔助器具幫忙 (n) = aid
數學 (n) = mathematics
日曆 (n) = calendar
小姐 (n) = Miss
愚蠢的 糊塗的 (adj) = silly
麻煩 困擾的事 (n) = trouble
酸的 (adj) = sour
最新的 (adj) = latest
那個 (det) = that
稀有的 罕見的 (adj) = rare
手段 方法 (n) = means
摩托車 (n) = motorcycle
報紙 (n) = newspaper
角色 (n) = role
同意 (v) = agree
零 (num) = zero
針 (n) = needle
進入 (v) = enter
表現 行為舉止 (v) = behave
鸚鵡 (n) = parrot
鼓勵 鼓舞 (v) = encourage
兩者都不 (adj) = neither
成功 (n) = success
近的 (adj) = near
降落 (v) = land
醫生 (n) = doctor
喜悅 (n) = joy
膠水 (n) = glue
曬乾 烘乾 變乾 (v) = dry
直接地 (adv) = straight
長方形 (n) = rectangle
夫人 太太 (n) = madam
妒忌 羨慕 (v) = envy
以前 (adv) = ago
事故 意外 (n) = accident
車票 入場券 (n) = ticket
一致的 不變的 (adj) = uniform
看見 (v) = see
女人 (n) = woman
神 上帝 (n) = God
下定決心 決定 (v) = determine
大叫 呼喊 (v) = shout
秋天 (n) = autumn
寺廟 神殿 (n) = temple
因此 (adv) = thus
有技巧的 (adj) = skillful
烏龜 (n) = turtle
沒什麼 (pron) = nothing
注意力 (n) = attention
故事 (n) = story
空調 (n) = air conditioner
橄欖球(美) 足球(英) (n) = football
最後的 最終的 (adj) = final
亞洲的 亞洲人 (n1) = Asian
喉嚨 (n) = throat
空的 (adj) = empty
女演員 (n) = actress
四十 (num) = forty
當前的 現行的 (adj) = current
告訴 (v) = tell
和...一樣 (prep) = like
律師 (n) = lawyer
包裹 (n) = package
寒冷的 (adj) = cold
真的 真實的 (adj) = true
到…裡面 (prep) = into
關心的事 關切的事 (n) = concern
驢 (n) = donkey
較好的 (adj) = better
令人興奮的 (adj) = exciting
腿 (n) = leg
雇用 (v) = hire
法國的 法國人 法語 (n1) = French
星期 (n) = week
好的 (adj) = good
無尾熊 (n) = koala
最初的 (adj) = primary
作用 效果 影響 (n) = effect
手套 (n) = glove
普通話 國語 (n) = Mandarin
孔子 (n) = Confucius
落後的 向下的 (adj) = down
使…驚恐 讓…害怕 (v) = frighten
盤子 (n) = plate
成員 (n) = member
特別的 (adj) = special
拉回 拖著 (v) = pull
好奇的 (adj) = curious
帳單 票據 (n) = bill
為什麼 (wh) = why
或許 可能 (adv) = perhaps
從未 (adv) = never
一 (num) = one
課本 (n) = textbook
畫底線 (v) = underline
每件事情 (pron) = everything
把…分成 (v) = divide
物品 文章 條款 (n) = article
筆 (n) = pen
強調 (v) = stress
弄壞 (v) = break
修理 補救 (v) = repair
加拿大 (n1) = Canada
十三 (num) = thirteen
霧 霧氣 (n) = fog
灰色的 (adj) = gray
她自己 (pron_R) = herself
打架 奮鬥 (v) = fight
藥物 (n) = medicine
每週一次 (adv) = weekly
陌生人 (n) = stranger
錯誤的 (adj) = wrong
美女 美麗 (n) = beauty
怎麼 (adv) = how
國家 (n) = nation
慶祝 (v) = celebrate
機場 (n) = airport
唯一的 僅有的 (adj) = only
來 (v) = come
第四 (num) = fourth
睡覺 (v) = sleep
留意 介意 (v) = mind
樓層 地板 (n) = floor
水果 果實 (n) = fruit
拇指 (n) = thumb
多雲的 (adj) = cloudy
厚的 (adj) = thick
人群 (n) = crowd
四分之一 (n) = quarter
害怕的 (adj) = afraid
和平 和睦 (n) = peace
房子 (n) = house
體育 (np) = physical education
計算 (v) = count
落下 跌倒 (v) = fall
舉行 抓住 (v) = hold
好看的 (adj) = nice-looking
我自己 (pron_R) = myself
奶奶 (n) = grandma
力氣 權力 威力 (n) = might
三明治 (n) = sandwich
骯髒的 (adj) = dirty
雲 (n) = cloud
自由 獨立自主 (n) = freedom
比 (conj) = than
回答 回覆 (v) = reply
非常地 (adv) = pretty
骨瘦如柴的 (adj) = skinny
只是 (adv) = just
有風的 (adj) = windy
橡膠 (n) = rubber
　一流的 (adj) = classic
開始 (v) = start
門 (n) = door
社會的 (adj) = social
天空 (n) = sky
蝙蝠 (n) = bat
投擲 丟出 (v) = throw
兄弟 (n) = brother
壘球 (n) = softball
啤酒 (n) = beer
血 血液 (n) = blood
二 (num) = two
包含 (prep) = including
工具 (n) = tool
傢伙 人(口語) (n) = guy
豬肉 (n) = pork
保齡球 (n) = bowling
放下 流下來 (v) = drop
我們的東西 (pron_n) = ours
歌手 (n) = singer
水準 標準 (n) = standard
藥品 (n) = drug
失蹤的 (adj) = missing
相同地 (adv) = alike
學習 研究 設置 (v) = study
什麼 (wh) = what
顏色 (n) = color
兩方 (pron) = both
棋 (n) = chess
狂風暴雨的 (adj) = stormy
哭 叫 喊 (v) = cry
在…之上 在…上面 (prep) = upon
射擊 (n2) = shot
組織 (n) = organization
舞台 講台 (n2) = stage
(太陽)升起 (v) = rise
害怕 恐懼 (n) = fear
八月 (n) = August
幼稚園 (n) = kindergarten
國際的 (adj) = international
兩倍的 加倍的 (adj) = double
健康的 良好的 (adj) = fine
教室 (n) = classroom
匆忙的 (adj) = rush
敲 擊 打 (v) = knock
激勵 啟發 (v) = inspire
教堂 (n) = church
飲料 (n) = drink
長笛 (n) = flute
負責任的 (adj) = responsible
拼寫 (v) = spell
台灣的 台灣人 台語 (n1) = Taiwanese
奇妙的 (adj) = fantastic
一對 一雙 (n) = pair
新年 (n) = New Year's Day
杯子 (n) = cup
控制力 (n) = control
堅果 核果 (n) = nut
星 (n) = star
十九 (num) = nineteen
生病的 (adj) = sick
她的東西 (pron_n) = hers
倒退地 (adv) = backward
單身的 (adj) = single
香港 (n1) = Hong Kong
鎖 (n) = lock
重擊 敲打 (v) = pound
時鐘 (n) = clock
看 注意 小心 手錶 (v) = watch
文件 文獻 (n) = document
毯子 (n) = blanket
小費 秘訣(竅門) 尖端 (n) = tip
和平的 (adj) = peaceful
任何的 (adj) = whatever
信件 (n) = letter
演說 演講 (n) = speech
月 (n) = month
懷疑 不相信 (n) = doubt
合法的 法定的 (adj) = legal
會痛的 (adj) = sore
嗜好 (n) = hobby
貿易 交易 (n) = trade
證明 證實 結果為… (v) = prove
目標 標靶 (n) = target
廣場 正方形 (n) = square
救護車 (n) = ambulance
每月的 按月的 (adj) = monthly
曲線 (n) = curve
壁櫃 內閣 (n) = cabinet
信用卡 (np) = credit card
缺點錯誤 過失 (n) = fault
前夕 (n) = eve
超重的 超載的 (adj) = over-weight
足踝 (n) = ankle
遵守 跟隨 (v) = follow
東西 事物 (n) = thing
在...以後 (prep) = after
較少的 (adj) = less
原諒 體諒 (n) = pardon
是否 (wh) = whether
較晚 (adv) = later
宇宙 全世界 (n) = universe
舉起 抬起 (v) = raise
程式 節目 (n) = program
吞下 嚥下 (v) = swallow
頭痛 (n) = headache
巨大的 龐大的 (adj) = huge
成功的 (adj) = successful
指揮(權) 領導能力 (n) = leadership
(研究)領域 (n2) = field
服從 遵守 (v) = obey
它自己 (pron_R) = itself
遍及 到處 從頭到尾 (prep) = throughout
六月 (n) = June
某處 (adv) = somewhere
追逐 追捕 (v) = chase
漁夫 (n) = fisherman
海鮮 (n) = seafood
寵物 (n) = pet
速率 速度 (n) = speed
電扇 歌迷 粉絲 (n) = fan
事實上 (adv) = actually
山 (n) = mountain
設計 構思 (v) = design
聰明的 (adj) = intelligent
四 (num) = four
命令 秩序 (n) = order
進口 (v) = import
襯衫 (n) = shirt
追蹤 留下腳印 (v) = track
美味可口的 (adj) = delicious
百萬 (num) = million
供應 (n) = supply
餃子 (n) = dumpling
油畫 繪畫 油漆 (n) = painting
腦 智力 (n) = brain
拒絕 (v) = reject
頁 (n) = page
更多的 (adj) = more
椅子 (n) = chair
滾動 打滾 (v) = roll
座位 (n) = seat
烘 烤 (v) = bake
國外的 (adj) = overseas
問題 (n) = problem
糖 (n) = sugar
烘乾機 (n) = dryer
勝利 贏得 (v) = win
橡皮的 橡膠的 (adj) = rubber
主人 (n) = host
回答 答覆 (n) = answer
沙漠 (n) = desert
拖(地) (v) = mop
以…為目標 (v) = target
收集 (v) = collect
產品 產物 成果 (n) = product
綠色的 (adj) = green
粉紅色的 (adj) = pink
花蓮 (n1) = Hualian
跳過 躍過 (v) = hop
巧克力 (n) = chocolate
蟲子 (n) = bug
高的 (adj) = tall
無 (pron) = none
系統 (adj) = systematic
有霧的 (adj) = foggy
地點 (n) = spot
污染 (n) = pollution
保佑 祝福 (v) = bless
早午餐 (n) = brunch
牙刷 (n) = toothbrush
可愛的 (adj) = cute
後面的 後半的 (adj) = latter
記號 (n) = mark
黑暗的 (adj) = dark
有苦味的 (adj) = bitter
螃蟹 (n) = crab
圖表 (n) = chart
末端 結束 (n) = end
工廠 (n) = factory
重大的 不錯的 (adj) = great
漿糊 (n) = paste
鐵路 (n) = railway
一餐 膳食 (n) = meal
餐巾 (n) = napkin
另一個 (adj) = another
植物的 疏菜的 (adj) = vegetable
治療(法) (n) = treatment
種族 (n2) = race
刀子 (n) = knife
點頭 (v) = nod
紅色的 (adj) = red
感到興趣的 (adj) = interested
這個 (det) = this
教練 (n) = coach
幾乎 差不多 (adv) = nearly
那裡 (adv) = there
浮出水面 浮現 出現 (v) = surface
俄國 (n1) = Russia
損失 (n) = loss
腳趾 (n) = toe
生氣的 (adj) = angry
原料 材料 (n) = material
鄉村 鄉下 (n1) = countryside
爵士樂(舞) (n) = jazz
願意的 樂意的 (adj) = willing
進步 (n) = progress
倫敦 (n1) = London
視野 風景 意見 (n) = view
科學家 (n) = scientist
教師節 (n) = Teacher's Day
方向 指引 (n) = direction
筆記 摘要 (n) = note
錯誤 差錯 (n) = error
蓋子 (n) = lid
完成 (v) = complete
開始 (v) = begin
球員 選手 (n) = player
鄰居 (n) = neighbor
圖書館 (n) = library
歷史 (n) = history
提醒 使…想起 (v) = remind
你們自己 (pron_R) = yourselves
金黃色的 (adj) = golden
獨特的 唯一的 (adj) = unique
電腦 (n) = computer
新聞界 新聞媒體 (n) = press
經理 (n) = manager
聰明的 (adj) = clever
信任 信賴 (v) = trust
求婚 提議 (v) = propose
丈夫 老公 (n) = husband
白色的 (adj) = white
練習 (v) = practice
浴缸 澡盆 (n) = tub
巴黎 (n1) = Paris
發現 (v) = discover
商人 (n) = businessman
嚴寒的 結冰的 (adj) = freezing
臥室 (n) = bedroom
戲劇 (n) = drama
敬重 尊敬 (n) = respect
客廳 (np) = living room
想睡的 (adj) = sleepy
長度 一段 (n) = length
踢 (v) = kick
豆 (n) = bean
見面 遇見 開會 (v) = meet
台南 (n1) = Tainan
稻米 (n) = rice
日本 (n1) = Japan
沙子 (n) = sand
小羊 (n) = lamb
外交官 (n) = diplomat
幾個的 數個的 (adj) = several
排 列 (n) = row
音量 容積 (n) = volume
需要 (v) = need
塗上顏色 油漆 作畫 (v) = paint
六 (num) = six
化學物品 (n) = chemical
不快樂的 (adj) = unhappy
九 (num) = nine
叉子 (n) = fork
屬於 (v) = belong
放棄 退出 (v) = quit
改變 (v) = change
計程車 (n) = taxi
能力 (n) = ability
確定地 (adv) = certainly
將軍 (n) = general
大廳 (n) = hall
海豚 (n) = dolphin
地理 地形 (n) = geography
菲律賓 (n1) = Philippines
抵達 達到 (v) = reach
適合 與...相稱 (v) = fit
法律 (n) = law
震驚 打擊 電擊 休克 (n) = shock
美國 (n) = America
惡毒的 小氣的 (adj) = mean
綁住 (v) = tie
說 講 (v) = say
細目 項目 (n) = item
那些 (det) = those
好運的 (adj) = lucky
說謊 (v) = lie
吃 (v) = eat
網球 (n) = tennis
分公司 樹枝 支流 (n) = branch
裝飾 (v) = decorate
範圍 幅度 射程 (n) = range
地毯 (n) = carpet
優良的 上等品質的 (adj) = quality
打電話 (v) = phone
船員 水手 (n) = sailor
選舉 推選 (v) = elect
自助餐館 (n) = cafeteria
經常 (adv) = often
寬的 (adj) = wide
郵局 (np) = post office
現在的 出席的 (adj) = present
方便的 便利的 (adj) = convenient
伯父 叔叔 (n) = uncle
廣告 (n) = advertisement
怕羞的 (adj) = shy
植物 (n) = plant
僅有的 只是 (adv) = only
打擊 襲擊 (v) = hit
腰部 (n) = waist
鐵 (n) = iron
相簿 專輯 (n) = album
誠實的 (adj) = honest
街道 (n) = block
相信 (v) = believe
訪客 遊客 (n) = visitor
根 (n) = root
隨身聽 (n) = Walkman
平底鍋 (n) = pan
天資 才華 天才 (n) = genius
飢餓 (n) = hunger
工程師 (n) = engineer
可樂 (n) = cola
坐 (v) = sit
快速的 急促的 (adj) = rapid
遠足 健行 (n) = hike
有禮貌的 (adj) = polite
醫院 (n) = hospital
台中 (n1) = Taichung
漢堡 (n) = hamburger
作業簿 習作本 (n) = workbook
囚犯 俘虜 (n) = prisoner
一百 (num) = hundred
鵝 (n) = goose
電影院 (n) = theater
骨頭 (n) = bone
小販 攤販 (n) = vendor
消失 不見 (v) = disappear
房間 (n) = room
手勢 (n) = gesture
熱的 (adj) = hot
束 (n) = bundle
準備好的 (adj) = ready
愛好 迷戀 (n) = fancy
第六的 (num) = sixth
人們 (n) = people
勸告 忠告 (v) = advise
舞蹈 (v) = dance
屋頂 車頂 (n) = roof
非常地 (adv) = quite
頭 (n) = head
慷慨的 (adj) = generous
星期五 (n) = Friday
觀眾 聽眾 (n) = audience
點燃 (v) = light
十一月 (n) = November
一點點 (adj) = little
錢包 (n) = wallet
五十 (num) = fifty
導演 指導者 (n) = director
老鼠 (n) = rat
滑梯 (n) = slide
河流 (n) = river
餐廳 (np) = dining room
蛋 (n) = egg
雜誌 (n) = magazine
泳裝 (n) = swimsuit
傍晚 (n) = evening
政策 方針 (n) = policy
乾淨的(無污染的) (adj) = clean
為…服務 (v) = serve
公斤 (n) = kilogram
皮膚 (n) = skin
來源 出處 (n) = source
會議 集會 (n) = meeting
保護 防護 (v) = protect
前面的 正面的 (adj) = front
物品 物體 目標 (n) = object
過去的 以前的 (adj) = past
飛機 (n) = airplane
生物學 (n) = biology
散佈 傳播 (v) = spread
到國外 (adv) = abroad
二月 (n) = February
一代 世代 (n) = generation
小聲的 低的 (adj) = low
下巴 (n) = chin
自然科學 (n) = science
權利 (n) = right
科目 主題 (n) = subject
等級 規模 (n) = scale
標題 書名 頭銜 (n) = title
水池 池塘 (n) = pool
沙發 (n) = sofa
天橋 (n) = overpass
分開 隔開 分居(手) (v) = separate
抬起 舉起 (v) = lift
黑板 (n) = blackboard
罪 罪行 (n) = crime
然而 但是 (adv) = however
離開 (adv) = away
向下 (adv) = down
車庫 (n) = garage
藥局 (n) = drugstore
自己(反身代名詞) (pron_r) = oneself
新聞記者 (n) = journalist
照相機 (n) = camera
煙霧 (n) = smoke
例子 (n) = example
蘇打 (n) = soda
意志 (n) = will
事件 (n) = event
進步 進展 (v) = advance
出口 通道 (n) = exit
發明 (v) = invent
貯存 (v) = store
穿著 戴著 (v) = wear
過去 (n) = past
連接 (v) = link
樓梯 (n) = stair
詩 (n) = poem
每日的 (adj) = daily
早的 (adj) = early
有空的 可得到的 (adj) = available
家鄉的 國內的 (adj) = home
也(不) (adv) = either
星期三 (n) = Wednesday
中國人民共和國 (n) = China
卡式磁帶 (n) = cassette
把...藏起來 (v) = hide
王國 (n) = kingdom
橘色的 (adj) = orange
團隊 (n) = team
醋 (n) = vinegar
掙扎 努力 奮鬥 搏鬥 (v) = struggle
讓 (v) = let
關節 (n) = joint
自然的 天生的 (adj) = natural
回收 (v) = recycle
玉米 (n) = corn
使…困惑 (v) = puzzle
五月 (n) = May
知道 (v) = know
注意聽 (v) = listen
說溜嘴 (v3) = slip
遲到的 (adj) = late
桃子 (n) = peach
頂部 頭頂 陀螺 (n) = top
他們自己 (pron_R) = themselves
兩次 兩回 (adv) = twice
抓住 趕上 (v) = catch
大的 (adj) = big
會話 談話 (n) = conversation
前面的 (adj) = forward
直排輪 (n) = roller-blades
贊成 支持 (n2) = favor
圍巾 (n) = scarf
形成 塑造 (v) = form
回答 回覆 (n) = reply
感恩節 (n) = Thanksgiving
週末 (n) = weekend
貪婪的 (adj) = greedy
籃球 (n) = basketball
烹調 (v) = cook
最小的 (adj) = least
再見 (inter) = goodbye
危機 緊要關頭 (n) = crisis
功課 課業 (n) = lesson
打擊 敲打 (v) = beat
飛盤　 (n) = Frisbee
著名的 (adj) = famous
對…做簡報 (v) = brief
平坦的 洩了氣的 (adj) = flat
主席 董事長 (n) = chairman
中部的 中間的 (adj) = middle
要素 成分 (n) = element
奇怪的 (adj) = strange
租 (v) = rent
音樂家 作曲家 (n) = musician
南方 (n) = south
炸薯條 (np) = French fries
調查 研究 (v) = investigate
一部份 (n) = part
確定的 可靠的 (adj) = certain
許多的 (adj) = much
鋼琴 (n) = piano
感覺 感受 (n) = feeling
星期一 (n) = Monday
這些 (det) = these
兩者任一的 (adj) = either
忽略 (v) = ignore
疼痛的 引起痛苦的 (adj) = painful
更進一步的 另外的 (adj1) = further
以…為範圍 延伸 (v) = range
螢幕 (n) = screen
清洗 (v) = wash
緊張的 (adj) = nervous
關於 (prep) = about
簡單的 (adj) = simple
輔助的 (adj) = assistant
樓下的 (adj) = downstairs
韓國的 韓國人 韓語 (n1) = Korean
中等的 中間的 (adj) = medium
初學者 (n) = beginner
人口 (n) = population
樓下 (adv) = downstairs
雪人 (n) = snowman
數量 (n) = amount
數學 (n) = math
復活節 (n) = Easter
小貓 (n) = kitten
教 (v) = teach
地圖 (n) = map
菜單 (n) = menu
香蕉 (n) = banana
太陽 (n) = sun
禮物 (n) = gift
德國的 德國人 德語 (n1) = German
快速地 (adv) = fast
郵件 (n) = mail
好吃的 (adj) = yummy
理解 (v) = understand
明信片 (n) = postcard
第五的 (adj) = fifth
花 (n) = flower
在…之上 (prep) = over
供應 供給 提供 (v) = supply
清楚的 (adj) = clear
活力 能源 (n) = energy
衣物櫃 置物櫃 (n) = locker
命令 (n) = command
銀器 銀幣 (n) = silver
第三的 (num) = third
健康的 安好的 (adj) = well
個人的 私人的 (adj) = private
前面 正面 (n) = front
活著的 (adj) = alive
象徵 標誌 (n) = symbol
憤怒 (n) = anger
流行的 受歡迎的 (adj) = popular
把...掛起 (v) = hang
可怕的 嚇人的 (adj) = terrible
在外 向外 (adv) = out
穿過 透過 (prep) = through
債務 債款 (n) = debt
受傷 (v) = hurt
支撐 支持 (v) = support
改善 提高 (v) = improve
西邊的 (adj) = west
長輩 (n) = elder
欠缺 不足 缺少 沒有 (n) = lack
北方 (n) = north
抉擇 (n) = choice
瓶子 (n) = bottle
以為 假定為 (v) = assume
警報 (n) = alarm
一半 (n) = half
記得 想起 (v) = remember
船 (n) = boat
體貼的 (adj) = considerate
牢房 細胞 (n) = cell
殘忍的 (adj) = cruel
讓…覺得不好意思 (v) = embarrass
桶子 (n) = bucket
混和 攙和 (v) = mix
汽油 (n) = gasoline
停車 (v) = park
開始 (n) = beginning
空間 (n) = space
正方形的 (adj) = square
肥皂 (n) = soap
較喜歡 寧願 (v) = prefer
他們的 (pron) = their
裙子 襯裙 (n) = skirt
城市 (n) = city
重量 (n) = weight
皇家 王室 (n) = royal
最後 終於 (adv) = finally
秋天 (n) = fall
聯合的 共同的 (adj) = joint
全體的 所有的 (adj) = whole
在...的後面 (prep) = behind
和...一起 (prep) = with
雪 (n) = snow
戒指 (n) = ring
未來 將來 (n) = future
精神 (n) = spirit
健康的 (adj) = healthy
完美的 理想的 (adj) = perfect
嚴重的 (adj) = serious
晚餐 (n) = supper
恩惠 幫忙 (n1) = favor
困難 艱難 (n) = difficulty
火柴 (n) = match
低熱量的 (adj) = diet
蜘蛛 (n) = spider
靈魂 (n) = soul
十一 (num) = eleven
幽默感 (n) = humor
九十 (num) = ninety
地方 (n) = place
船艦 (n) = ship
可以 可能 (aux) = may
關鍵的 (adj) = key
軍事的 軍人的 (adj) = military
認為 視為 (v) = view
發現 (v) = find
眼睛 (n) = eye
物理學 (n) = physics
熊貓 (n) = panda
加入 連結 (v) = join
部門 科系 (n) = department
目的 目標 (n) = goal
老師 (n) = teacher
短的 (adj) = short
棉花 (n) = cotton
期望 (v) = expect
但是 (conj) = but
行銷 上市 (v) = market
蘋果 (n) = apple
南方的 (adj) = south
痕跡 (n) = trace
紳士 (n) = gentleman
逮捕 拘捕 (v) = arrest
胡椒 (n) = pepper
安心 輕鬆 (n) = ease
葉子 (n) = leaf
幾乎 差不多 (adv) = almost
可怕的 恐怖的 (adj) = horrible
一分 (n) = cent
感到無聊的 (adj) = bored
第九的 (num) = ninth
衝突 (v) = conflict
安全 平安 (n) = safety
番茄醬 (n) = ketchup
液體 (n) = liquid
承諾 保證 (n) = promise
森林 (n) = forest
重複 重做 (v) = repeat
愉快的 (adj) = happy
傘 (n) = umbrella
顯示 露出 (v) = show
條(麵包) (n) = loaf
大量 大眾 (n) = mass
每月地 按月地 (adv) = monthly
天使 (n) = angel
電影 (n) = movie
前進 轉寄 (adv) = forward
往樓上 (adv) = upstairs
癌症 惡性腫瘤 (n) = cancer
鬍鬚 (n) = beard
使用者 (n) = user
大部份的 (adj) = most
辯論 爭論 討論 (n) = debate
中心 中央 (n) = center
母親 (n) = mother
年長的 資深的 (adj) = senior
影響 對...發生作用 (v) = affect
手 (n) = hand
秒 (n) = second
女性的 雌性的 (adj) = female
警察 (n) = policeman
解決(方法) 解答 (n) = solution
租金 房租 (n) = rent
婚禮 (n) = wedding
靜止的 (adj) = still
草莓 (n) = strawberry
頑皮的 (adj) = naughty
通常的 平常 (adj) = ordinary
點鐘 (adv) = o'clock
意見 主張 (n) = opinion
點餐 命令 (v) = order
為…乾杯 (V) = toast
重要的 (adj) = important
果汁 (n) = juice
擔心 發愁 (v) = worry
栽種 (v) = plant
紐約 (n1) = New York
羽毛球 (n) = badminton
笑 嘲笑 (v) = laugh
學校 (n) = school
環境 (n) = environment
物主 所有人 (n) = owner
女兒 (n) = daughter
小徑 小路 (n) = path
睡著的 (adj) = asleep
以下的 (adj) = following
大叫 (v) = yell
比賽 (n) = race
小圓麵包 (n) = bun
實話 事實 實情 (n) = truth
牛仔 (n) = cowboy
除...之外 (prep) = except
考試 (n) = exam
天氣 (n) = weather
功能 機能 (n) = function
記者 (n) = reporter
(書籍)篇 章 (n) = chapter
沈默的 (adj) = silent
說話 講話 (v) = speak
完全 全部 (adv) = altogether
自私的 (adj) = selfish
高中 (np) = senior high school
考慮 細想 (v) = consider
氣球 (n) = balloon
颱風 (n) = typhoon
問候 打招呼 (v) = greet
魔術師 (n) = magician
法國 (n1) = France
聲音 (n) = sound
制服 (n) = uniform
注意到 告知 (v) = notice
機器人 (n) = robot
化學的 (adj) = chemical
打電話 (v) = call
帽子 (n) = hat
公主 (n) = princess
動物 (n) = animal
決定 決心 (n) = decision
外國人 (n) = foreigner
牛肉 (n) = beef
睡衣褲 恆為複數 (n) = pajamas
亦不用於否定 (conj) = nor
穿著講究者 梳妝檯 (n) = dresser
點 (n) = dot
煩擾 打攪 (v) = bother
測試 小考 (n) = test
震驚 給予打擊 使受電擊 (v) = shock
牆壁 (n) = wall
滑雪屐 (n) = ski
坦白的 直率的 (adj) = frank
洋蔥 (n) = onion
毒物 (n) = poison
全部的 完全的 (adj) = total
躺下 (v2) = lie
採納 採用 收養 (v) = adopt
一點點 (n) = bit
旅館 飯店 (n) = hotel
一些 (det) = some
青草 (n) = grass
人行道 (n) = sidewalk
意象 影像 形象 (n) = image
甚至 連 (adv) = even
公尺 (n) = meter
程度 度數 (n) = degree
拼(字) (n) = spelling
治療 對待 看待 (v) = treat
吹 隨風飄動 (v) = blow
五 (num) = five
單獨地獨自地 (adv) = alone
證實 確定 (v) = confirm
邀請 (n) = invitation
分開的 個別的 (adj) = separate
法院 (n) = court
咳嗽 (v) = cough
數字 (n) = number
發展 (v) = develop
蜜蜂 (n) = bee
固定 修理 (v) = fix
有耐心的 (adj) = patient
形狀 (n) = shape
昆蟲 (n) = insect
正好是 (adj) = very
價值 評價 (n) = value
改正 (v) = correct
味覺 (n) = taste
擁有 (v) = own
英雄 勇士 (n) = hero
玫瑰花 (n) = rose
傢俱 (n) = furniture
火腿 (n) = ham
彩虹 (n) = rainbow
勸告 忠告 (n) = advice
雄性的 男子的 (adj) = male
巨大的 (adj) = giant
在...的上面 (prep) = above
烤肉 (n) = barbecue
推 推動 (v) = push
站立 站著 (v) = stand
駕駛 (v) = drive
也(肯定句) (adv) = too
以前的 前任的 (adj) = former
天鵝 (n) = swan
想法、主意 (n) = idea
保持 保留 (v) = keep
微波 (n) = microwave
很少 難得 (adv) = seldom
多雨的 (adj) = rainy
嘗試 (v) = try
沙拉 (n) = salad
一年一度地 每年地 (adv) = yearly
字母表 (n) = alphabet
夾克 (n) = jacket
愚笨的 (adj) = stupid
車站 (n) = station
苗條的 (adj) = slender
抱怨 訴說(病痛) (v) = complain
星期二 (n) = Tuesday
鳳梨 (n) = pineapple
桌子 (n) = table
喝 (v) = drink
行星 (n) = planet
管子 (n) = pipe
機會 時機 (n) = opportunity
蓋(房子) (v) = build
額外的 外加的 (adj) = extra
複習 回顧 (n) = review
收到 接到 (v) = receive
交通 (n) = traffic
梳 (v) = comb
購物中心 大賣場 (n) = mall
幫助 (v) = help
雨水 (n) = rain
必要的 (adj) = necessary
打擊 攻擊 (v) = strike
膽量 勇氣 (n) = courage
投入 (v) = put
組織 成立 主辦 籌辦 (v) = organize
治癒 (n) = cure
雄偉的 壯麗的 (adj) = grand
現代的 (adj) = modern
每一個 (det) = every
月亮 (n) = moon
溜直排輪 (v) = roller-skate
豔陽高照的 (adj) = sunny
飲料(無酒精) (np) = soft drink
旅行 (n) = travel
陽臺 (n) = balcony
氣候 (n) = climate
樹 (n) = tree
年 (n) = year
地區 區域 (n) = region
極好的 (adj) = wonderful
危險 (n) = danger
課程 路線 (n) = course
鋒利的 尖的 (adj) = sharp
試驗 審判 考驗 (n) = trial
國中 (np) = junior high school
爺爺 (n) = grandpa
蕃茄 (n) = tomato
一滴 ( n) = drop
喜愛 享受 欣賞 (v) = enjoy
鴨舌帽 (n) = cap
身體 (n) = body
仍然 (adv) = still
錯誤 過失 (n) = mistake
公園 (n) = park
獅子 (n) = lion
猜測 (v) = guess
雷 (n) = thunder
祝賀 (n) = congratulation
藝術 (n) = art
打包 背部 (n) = back
預先 事先 (n) = advance
管子 (n) = tube
向前 (adv) = ahead
暫停 間歇 (n) = pause
孩子 (n) = kid
淑女 女士 (n) = lady